0 0 0 b 5 0
5 0 b 1 1 1
0 0 0 0 5 5
5 5 0 0 b 1
1 0 0 s 0 1
1 0 0 0 0 1
